F        220       ,  				100,      5

	  NO textures/wolfenstein/mossy.xpm 
	  
	  
     WE   		    textures/wolfenstein/mossy.xpm
EA textures/wolfenstein/mossy.xpm

SO textures/wolfenstein/mossy.xpm
C 225,30,0

01110
10S01
10001
10001
10001
10001
10001
10001
11110