NO ../textures/Wall_Stone_022_basecolor.xpm
SO ../textures/Wall_Stone_022_basecolor.xpm
WE ../textures/Wall_Stone_022_basecolor.xpm
EA ../textures/Wall_Stone_022_basecolor.xpm

F 220,100,0
C 225,30,0


	1111111111111111111111111  
	100000000110000000000001
	1111000001110000000000001
	10000000000000000000000011111
11111111011000001110000000000001
100000000011000001110111111111111
1111011111111101110000001000011
11110111111111011101010010000001
10000001101010111000000100111011
100000000000000011000000100N0001
10000000000000001101010010001111
11000001110101011111011110111
11110111 1110101 101111010001
11111111 1111111 111111111111
11111111 1111111 111111111111
