NO textures/Wall_Stone_022_basecolor.xpm
SO textures/eagle.xpm
WE textures/wood.xpm
EA textures/purplestone.xpm

F 180,95,6
C 5,159,220


	1111111111111111111111111  
	100000000110000000000001
	11110000011100000S0000001
	10000000000000000000000011111
11111111011000001110000000000001
100000000011000001110111111111111
1111011111111101110000001000011
11110111111111011101010010000001
10000001101010111000000000111011
10000000000000001100000010000001
10000000000000001101010010001111
11000001110101011111011110111
11110111 1110101 101111010001
11111111 1111111 111111111111
11111111 1111111 111111111111
